....................
....................
....................
...........ooo......
...........o.o......
...........oso......
...........o.o......
...........o.o......
oooooooooooo.ooooooo
....................
ooooooooo...oooooooo
....................
.ooooooooooooooooo..
....................
ooooooo....ooooooooo
....................
.....ooooooo........
....................
........l...........
.......ooo..........
