....................
....................
....................
...........ooo......
...........o.o......
...........oso......
...........o.o......
...........o.o......
oooooooooooo.ooooooo
...........e........
ooooooooo...oooooooo
...e.........e......
.ooooooooooooooooo..
......e.............
ooooooo....ooooooooo
...........e........
.....ooooooo........
....................
........l......eee..
.......ooo..........
