....................
....................
....................
....................
....................
....................
....................
....................
oooooooooooooooooooo
.......ol.....o.....
.......oooee.oo.....
.........o....o.....
.........oo.e.o.....
.........o....o.....
.........o.e.oo.....
.........o....o.....
......oooooe..o.....
......o.......o.....
......o.s....oo.....
......ooooooooo.....
