....................
....................
....................
....................
....................
....................
....................
....................
oooooooooooooooooooo
........l.....o.....
.......oooee.oo.....
.....o...o....o.....
.........oo.e.o.....
.....o...o....o.....
.........o.e.oo.....
.....o...o....o.....
......oooooe..o.....
.....oo.......o.....
......o.s....oo.....
.....oooooooooo.....
