....................
....................
....................
....................
....................
....................
....................
....................
oooooooooooooooooooo
.......ol.....o.....
.......oooee.oo.....
.........o....o.....
.........oo.e.o.....
........oo....o.....
........o..eooo.....
........oo....o.....
......oooooe..o.....
......o.......o.....
......o.s...ooo.....
......ooooooooo.....
