....................
....................
....................
....................
....................
....................
....................
.......o............
o......o...........o
o......os...........
o......ooo.....r.oo.
o........oooooooooo.
o.................o.
o.................o.
..................o.
oooo..r..r..rrr.o.oo
...oooooooooooooo...
oo......oooooooooooo
.......looooooooooo
.ooooooooooooooooooo
