....................
....................
....................
....................
..k.....o...........
.iii....o...........
........o.oor.......
........o.o.o.......
........o.o..o......
........o.o...o.....
........o.o....o....
........o.o.....or..
........o.o......o..
........o.o.......o.
........o.o........o
o.......o.o.........
.or.....o.o.........
..o.....o.o.........
...o...solo.........
....ooooooo.........
