....................
....................
....................
....................
....................
....................
....................
....l...............
.oooooooo..e...ee...
o.......o..e...ee...
........o..........o
........o.........o.
........oe....e..o..
........oe....e.o...
........o......o....
........o.....o.....
........o..e.o......
........o..eo.......
........os.o........
........ooo.........
