....................
....................
....................
....................
....................
....................
....................
....................
....................
...l................
ooooooooo..e...ee..o
........o..e...ee.o.
........o........o..
........oe....e.o...
........oe....eo....
........o.....o.....
........o..e.o......
........o..eo.......
........os.o........
........ooo.........
